................................................................................................................................................................................................................................................................................................................................................................................................................
................................................................................................................................................................................................................................................................................................................................................................................................................
................................................................................................................................................................................................................................................................................................................................................................................................................
................................................................................................................................................................................................................................................................................................................................................................................................................
................................................................................................................................................................................................................................................................................................................................................................................................................
................................................................................................................................................................................................................................................................................................................................................................................................................
................................................................................................................................................................................................................................................................................................................................................................................................................
................................................................................................................................................................................................................................................................................................................................................................................................................
................................................................................................................................................................................................................................................................................................................................................................................................................
................................................................................................................................................................................................................................................................................................................................................................................................................
................................................................................................................................................................................................................................................................................................................................................................................................................
.....................................................................................................................................................................................................................................................................................................................................................................................p..........................
...................................................................................................................................................................................................................................................................................................................................................................................XXXXX........................
.................................................................................................................................................................................................................................................................................................................................................................................XXXXXXX........................
................................................................................................................................................................................................................................................................................................................................................................................XXXXXXXX........................
...............................................................................................................................................................................................................................................................................................................................................................................XXXXXXXX.........................
...............................................................................................................................................................................................................................................................................................................................................................................XXXXXXXX.........................
...............................................................................................................................................................................................................................................................................................................................p..............................................XXXXXXXX..........................
..............................................................................................................................................................................................................................................................................................................b..............................................................XXXXXXXX....................XXXXXX.
.................................................................................................................................................................................................................................................................................................XXXXXXXX.............XXXXXXXXXXXXXXXXXX.....................................XXXXXXX....................XXXXXXXX
................................................................................................................................................................................................................................................................................................XX.XXXXXXXX...........X................XXXX..................................XXXXX.....................XXXXXXXXX
...............................................................................................................................................................................................................................................................................................XX...XXXXXXXX..........X...................XXX........................................................XXXXXXXXXXX
..............................................................................................................................................................................................................................................................................................X........XXXXXX.........X.....................XX......................................................XXXXXXXXXXXX
.............................................................................................................................................................................................................................................................................................XX........X...XX.........X......................XX...................................................XXXXXXXXXXXXXX
.................................................................................................................................................b..........................................................................................................................................XX.........X....X.........X........................X.................................................XXXXXXXXXXXXXXX
...........................................................................................................................................................................................................................................................................................XX..........X....X.........X........................XX...................p..........................XXXXXXXXXXXXXXXXX
..........................................................................................................................................................................................................................................................................................XX...........X....XX........X.........................XX...........................................XXXXXXXXXXXXXXXXXXX
.........................................................................................................................................................................................................................................................................................XX............X.....X........X..........................XX.............XXXXXXXXX..................sXXXXXXXXXXXXXXXXXXXX
.........................................................................................................................................................................................................................................................................................X............XX.....X........X...........................XX............XXXXXXXXX.................XXXXXXXXXXXXXXXXXXXXXX
........................................................................................................................................................................................................................................................................................XX............X......X........X............................X.............XXXXXXXX................XXXXXXXXXXXXXXXXXXXXXXX
.......................................................................................................................................................................................................................b................................................................X.............X......X........X............................XX............XXXXXXXX..............XXXXXXXXXXXXXXXXXXXXXXXXX
.......................................................................................................................................................................................................................................................................................XX.............X......X........X.............................X............XXXXXX..............XXXXXXXXXXXXXXXXXXXXXXXXXXX
.......................................................................................................................................................................................................................................................................................X.............XX......XX.......X.............................X..............................XXXXXXXXXXXXXXXXXXXXXXXXXXXXX
....................................................................................................................................................b.................................................................................................................................XX.............X........X.......X..............................X...........................XXXXXXXXXXXXXXXXXXXXXXXXXXXXXXX
.....................................................................................................................................................................................................................................................................................XX..............X........X.......X..............................X.........................XXXXXXXXXXXXXXXXXXXXXXXXXXXXXXXXX
....................................................................................................................................................................................................................................................................................XX..............X.........X.......XX.............................XX.......................XXXXXXXXXXXXXXXXXXXXXXXXXXXXXXXXXX
....................................................................................................................................................................................................................................................................................X...............X.........X........X..............................X.....................XXXXXXXXXXXXXXXXXXXXXXXXXXXXXXXXXXXX
...................................................................................................................................................................................................................................................................................X..........................X........X..............................XX...................XXXXXXXXXXXXXXXXXXXXXXXXXXXXXXXXXXXXX
..................................................................................................................................................................................................................................................................................X...........................X........X...............................X................XXXXXXXXXXXXXXXXXXXXXXXXXXXXXXXXXXXXXXXX
.................................................................................................................................................$.$.............................................................................................................................XX...........................X....$.$.XX..............................XX.............XXXXXXXXXXXXXXXXXXXXXXXXXXXXXXXXXXXXXXXXXX
..........................................................................................................................$......................................................................................................................................................X............................X$ $......X...............................X....$.....XXXXXXXXXXXXXXXXXXXXXXXXXXXXXXXXXXXXXXXXXXXXX
.....................................................................................................$......XXXXXXXXXXX.............XXXXXXXXXXXXXXXXXXXXXXXXXXXXXXXXXXXXX.......................................................................................................XX............................X....XXXXXXXXXXXXXXXXXXXXXXXXXXXXXXXXXXXXXXX.......XXXXXXXXXXXXXXXXXXXXXXXXXXXXXXXXXXXXXXXXXXXXXXX
.......................................................................................................XXXXXXXXXXXXXXXXXXXXXXXXXXXXXXXXXXXXXXXXXXXXXXXXXXXXXXXXXXXXXXXXXXXXXXXXXXXX.......s....................................................................................XX.......XXXXXXXXXXXXXXXXXXXXXXXXXXXX....X.............................XX..XXXXXXXXXXXXXXXXXXXXXXXXXXXXXXXXXXXXXXXXXXXXXXXXXXXXXX
..............................................................................................XXXXXXXXXXXXXXXXXXXXXXXXXXXXXXXXXXXXXXXXXXXXXXXXXXXXXXXXXXXXXXXXXXXXXXXXXXXXXXXXXXXXXXXXXXXXXXXX........................XXXXXXXXXXXXXXXX...........XXX...........................XXXXXXXXX.......................................................................XXXXXXXXXXXXXXXXXXXXXXXXXXXXXXXXXXXXXXXXXXXXXXXXX
................XXXXXXXXXXXXXXXXX...........XXXXXX................................XXXXXXXXXXXXXXXXXXXXXXXXXXXXXXXXXXXXXXXXXXXXXXXXXXXXXXXXXXXXXXXXXXXXXXXXXXXXXXXXXXXXXXXXXXXXXXXXXXXXXXXXXXXXXXXXXX....XXXXXXXXXXXXXXXXXXXXXXXXXXXXXXXXXXXXXXXXXXXX...............$.$.....XXXXXX..............................................................................XXXXXXXXXXXXXXXXXXXXXXXXXXXXXXXXXXXXXXXXXXXXXXXXX
............XXXXXXXXXXXXXXXXXXXXXXXXXXXXX...XXXXXXXXXXXXXX...............XXXXXXXXXXXXXXXXXXXXXXXXXXXXXXXXXXXXXXXXXXXXXXXXXXXXXXXXXXXXXXXXXXXXXXXXXXXXXXXXXXXXXXXXXXXXXXXXXXXXXXXXXXXXXXXXXXXXXXXXXXXXXXXXXXXXXXXXXXXXXXXXXXXXXXXXXXXXXXXXXXXXXXXXXXXXXXXX...............XXXX...................................................................................XXXXXXXXXXXXXXXXXXXXXXXXXXXXXXXXXXXXXXXXXXXXXXXXX
.........XXXXXXXXXXXXXXXXXXXXXXXXXXXXXXXXXXXXXXXXXXXXXXXXXXXXXXXXXXXXXXXXXXXXXXXXXXXXXXXXXXXXXXXXXXXXXXXXXXXXXXXXXXXXXXXXXXXXXXXXXXXXXXXXXXXXXXXXXXXXXXXXXXXXXXXXXXXXXXXXXXXXXXXXXXXXXXXXXXXXXXXXXXXXXXXXXXXXXXXXXXXXXXXXXXXXXXXXXXXXXXXXXXXXXXXXXXXXXXXXXXXXXXXXXXXXXXXX......................................................................................XXXXXXXXXXXXXXXXXXXXXXXXXXXXXXXXXXXXXXXXXXXXXXXXX
XXXXXXXXXXXXXXXXXXXXXXXXXXXXXXXXXXXXXXXXXXXXXXXXXXXXXXXXXXXXXXXXXXXXXXXXXXXXXXXXXXXXXXXXXXXXXXXXXXXXXXXXXXXXXXXXXXXXXXXXXXXXXXXXXXXXXXXXXXXXXXXXXXXXXXXXXXXXXXXXXXXXXXXXXXXXXXXXXXXXXXXXXXXXXXXXXXXXXXXXXXXXXXXXXXXXXXXXXXXXXXXXXXXXXXXXXXXXXXXXXXXX.....XXXXXXXXXXXXXXXXXXXXXXXXXXXXXXXXXXXXXXXXXXXXXXXXXXXXXXXXXXXXXXXXXXXXXXXXXXXXXXXXXXXXXXXXXXXXXXXXXXXXXXXXXXXXXXXXXXXXXXXXXXXXXXXXXXXXXXXXXXXXXXXXXXXXXXX
