....................................................................................................
....................................................................................................
....................................................................................................
....................................................................................................
....................................................................................................
....................................................................................................
....................................................................................................
....................................................................................................
....................................................................................................
....................................................................................................
....................................................................................................
....................................................................................................
....................................................................................................
....................................................................................................
....................................................................................................
....................................................................................................
......................................X..................d..........................................
.......................................XXXXXX.......................................................
.............................................XXXXXXXX...............................................
.....................................................XXXXXXXXXX.....................................
...............................................................XXXXXXXXXXXXXXXXXXXXXXXXXXXXXXXXXXXXX
....................................................................................................
....................................................................................................
....................................................................................................
...........X........................................................................................
....................................................................................................
....................................................................................................
....................................................................................................
....................................................................................................
..........................XXXXXXXXXXXXXXXXXXXXXXXXX.................................................
....................................................................................................
....................................................................................................
....................................................................................................
....................................................................................................
....................................................................................................
XXXXXXXXXXXXXXXXX...................................................................................
....................................................................................................
....................................................................................................
....................................................................................................
....................................................................................................
....................................................................................................
....................................................................................................
....................................................................................................
....................................................................................................
....................................................................................................
.........................e..........................................................................
....................................................................................................
......XXXXXXXXXXXXXXXXXXXXXXXXXXXXXXXXXXX...........................................................
XXXXXXX.............................................................................................
....................................................................................................
....................................................................................................
....................................................................................................
....................................................................................................
....................................................................................................
....................................................................................................
............................................e.......................................................
....................................................................................................
........................................XXXXXXXXXX..................................................
....................................................................................................
....................................................................................................
....................................................................................................
....................................................................................................
....................................................................................................
...........................................................XXXXX....................................
....................................................................................................
....................................................................................................
....................................................................................................
....................................................................................e...............
....................................................................................................
..............................................................................XXXXXXXXXXXXXX........
....................................................................................................
....................................................................................................
....................................................................................................
....................................................................................................
....................................................................................................
....................................................................................................
....................................................................................................
....................................................................................................
....................................................................................................
....................................................................................................
....................................................................................................
.....................................................................................e..............
.........................................................................................XXXXXXXXXXX
.................................................................................XXXXXXXX...........
...........................................................................XXXXXX...................
......................................................................XXXXX.........................
....................................................................XX..............................
..................................................................XX................................
.................................................e............XXXXX.................................
........................................................XXXXXX......................................
.......................................XXXXXXXXXXXXXXXXX............................................
....................................XXXX............................................................
....................................................................................................
....................................................................................................
...................e................................................................................
....................................................................................................
....................................................................................................
............XXXXXXXXXXXXXX..........................................................................
....................................................................................................
....................................................................................................
....................................................................................................
....................................................................................................
....................................................................................................
....................................................................................................
....................................................................................................
....................................................................................................
....................................................................................................
....................................................................................................
....................................................................................................
....................................................................................................
..............e.....................................................................................
....................................................................................................
XXXXXXXXXXXXXXXXXXXXX...............................................................................
.....................XXXXXXX........................................................................
............................XXXXXXXXXXX...........e.................................................
......................................XXXX..........................................................
.........................................XXXXXXXXXXXXXXXX...........................................
........................................................XXXXXXXXX...................................
....................................................................................................
....................................................................................................
....................................................................................................
....................................................................................................
....................................................................................................
....................................................................................................
....................................................................................................
....................................................................................................
....................................................................................................
....................................................................................................
................................................................................e...................
....................................................................................................
............................................................................XXXXXXXXXXX.............
..............................................................XXXXXXXXXXX...........................
....................................................................................................
....................................................................................................
....................................................................................................
....................................................................................................
....................................................................................................
....................................................................................................
....................................................................................................
....................................................................................................
....................................................................................................
....................................................................................................
..............................i.....................................................................
....................................................................................................
................................................e...................................................
.........................XXXXXXXXXX.................................................................
...................................XXXXXXXXXXXXXXXXXXXXXXXXXXXXXXX..................................
....................................................................................................
....................................................................................................
....................................................................................................
....................................................................................................
....................................................................................................
....................................................................................................
....................................................................................................
....................................................................................................
..........XXXXX.XXXXXXXX..............................................................e.............
........................................................................i...........................
....................................................................................................
..............................................................................XXXXXXXXXXXXXXXXXXXXXX
...........................................................XXXXXXXXXXXXXXXXXXXX.....................
....................................................................................................
....................................................................................................
....................................................................................................
....................................................................................................
....................................................................................................
..........................................e.........................................................
....................................................................................................
.....................................XXXXXXXXX......................................................
..................................................................X...XX.X.XXXX.X......X.X..........
...........p.......................................................................X................
....................................................................................................
....................................................................................................
....................................................................................................
...................................................XXX..............................................
.................................................................X........X.........................
....................................................................................................
....................................................................................................
..............................................................................................e.....
.i......XXXXXXXXXXXXXXXXXXXXXXXXXXX.................................................................
........XXXXXXXXXXXXXXXXXXXXXXXXXXX....................e............................................
........XXXXXXXXXXXXXXXXXXXXXXXXXXX.........................................................XXXXXXXX
........XXXXXXXXXXXXXXXXXXXXXXXXXXX.............................................XXXXXXXXXXXXXXXXXXXX
XXXXXXXXXXXXXXXXXXXXXXXXXXXXXXXXXXXXXXXXXXXXXXXXXXXXXXXXXXXXXXXXXXXXXXXXXXXXXXXXXXXXXXXXXXXXXXXXXXXX
XXXXXXXXXXXXXXXXXXXXXXXXXXXXXXXXXXXXXXXXXXXXXXXXXXXXXXXXXXXXXXXXXXXXXXXXXXXXXXXXXXXXXXXXXXXXXXXXXXXX
XXXXXXXXXXXXXXXXXXXXXXXXXXXXXXXXXXXXXXXXXXXXXXXXXXXXXXXXXXXXXXXXXXXXXXXXXXXXXXXXXXXXXXXXXXXXXXXXXXXX
XXXXXXXXXXXXXXXXXXXXXXXXXXXXXXXXXXXXXXXXXXXXXXXXXXXXXXXXXXXXXXXXXXXXXXXXXXXXXXXXXXXXXXXXXXXXXXXXXXXX
XXXXXXXXXXXXXXXXXXXXXXXXXXXXXXXXXXXXXXXXXXXXXXXXXXXXXXXXXXXXXXXXXXXXXXXXXXXXXXXXXXXXXXXXXXXXXXXXXXXX
XXXXXXXXXXXXXXXXXXXXXXXXXXXXXXXXXXXXXXXXXXXXXXXXXXXXXXXXXXXXXXXXXXXXXXXXXXXXXXXXXXXXXXXXXXXXXXXXXXXX
XXXXXXXXXXXXXXXXXXXXXXXXXXXXXXXXXXXXXXXXXXXXXXXXXXXXXXXXXXXXXXXXXXXXXXXXXXXXXXXXXXXXXXXXXXXXXXXXXXXX
XXXXXXXXXXXXXXXXXXXXXXXXXXXXXXXXXXXXXXXXXXXXXXXXXXXXXXXXXXXXXXXXXXXXXXXXXXXXXXXXXXXXXXXXXXXXXXXXXXXX
XXXXXXXXXXXXXXXXXXXXXXXXXXXXXXXXXXXXXXXXXXXXXXXXXXXXXXXXXXXXXXXXXXXXXXXXXXXXXXXXXXXXXXXXXXXXXXXXXXXX
XXXXXXXXXXXXXXXXXXXXXXXXXXXXXXXXXXXXXXXXXXXXXXXXXXXXXXXXXXXXXXXXXXXXXXXXXXXXXXXXXXXXXXXXXXXXXXXXXXXX
XXXXXXXXXXXXXXXXXXXXXXXXXXXXXXXXXXXXXXXXXXXXXXXXXXXXXXXXXXXXXXXXXXXXXXXXXXXXXXXXXXXXXXXXXXXXXXXXXXXX
XXXXXXXXXXXXXXXXXXXXXXXXXXXXXXXXXXXXXXXXXXXXXXXXXXXXXXXXXXXXXXXXXXXXXXXXXXXXXXXXXXXXXXXXXXXXXXXXXXXX
XXXXXXXXXXXXXXXXXXXXXXXXXXXXXXXXXXXXXXXXXXXXXXXXXXXXXXXXXXXXXXXXXXXXXXXXXXXXXXXXXXXXXXXXXXXXXXXXXXXX
XXXXXXXXXXXXXXXXXXXXXXXXXXXXXXXXXXXXXXXXXXXXXXXXXXXXXXXXXXXXXXXXXXXXXXXXXXXXXXXXXXXXXXXXXXXXXXXXXXXX
XXXXXXXXXXXXXXXXXXXXXXXXXXXXXXXXXXXXXXXXXXXXXXXXXXXXXXXXXXXXXXXXXXXXXXXXXXXXXXXXXXXXXXXXXXXXXXXXXXXX
XXXXXXXXXXXXXXXXXXXXXXXXXXXXXXXXXXXXXXXXXXXXXXXXXXXXXXXXXXXXXXXXXXXXXXXXXXXXXXXXXXXXXXXXXXXXXXXXXXXX
XXXXXXXXXXXXXXXXXXXXXXXXXXXXXXXXXXXXXXXXXXXXXXXXXXXXXXXXXXXXXXXXXXXXXXXXXXXXXXXXXXXXXXXXXXXXXXXXXXXX
XXXXXXXXXXXXXXXXXXXXXXXXXXXXXXXXXXXXXXXXXXXXXXXXXXXXXXXXXXXXXXXXXXXXXXXXXXXXXXXXXXXXXXXXXXXXXXXXXXXX
