................................................................................
................................................................................
................................................................................
................................................................................
................................................................................
................................................................................
................................................................................
................................................................................
................................................................................
................................................................................
................................................................................
................................................................................
................................................................................
................................................................................
................................................................................
................................................................................
................................................................................
................................................................................
................................................................................
................................................................................
................................................................................
................................................................................
................................................................................
................................................................................
................................................................................
................................................................................
................................................................................
................................................................................
................................................................................
................................................................................
................................................................................
................................................................................
.................................XXXXXXXXXXXXXXXXXXXXX..........................
...................................XXXXXXXXXXXXXXXXXXXXX........................
....................................XXXXXXXXXXXXXXXXXXXXX.......................
..................................XXXXXXXXXXXXXXXXXXXXX.........................
..............................XXXXXXXXXXXXXXXXXXXXX.............................
........................................XXXXXXXXXXXXXXXXXXXXX...................
..........................................XXXXXXXXXXXXXXXXXXXXX.................
............................................XXXXXXXXXXXXXXXXXXXXX...............
................................................................................
................................................................................
................................................................................
................................................................................
................................................................................
...............................................d................................
.............................%..................................................
....................................................,...........................
............................................XXXXXXXXXXXXXXXXXXXXX...............
............................................XXXXXXXXXXXXXXXXXXXXX...............
............................................XXXXXXXXXXXXXXXXXXXXX...............
............................................XXXXXXXXXXXXXXXXXXXXX...............
.................................e..........XXXXXXXXXXXXXXXXXXXXX...............
...........................XXXXXXXXX........XXXXXXXXXXXXXXXXXXXXX...............
...........................X................XXXXXXXXXXXXXXXXXXXXX...............
...........................X................XXXXXXXXXXXXXXXXXXXXX...............
...........................X................XXXXXXXXXXXXXXXXXXXXX...............
...........................X................XXXXXXXXXXXXXXXXXXXXX...............
...........................X................XXXXXXXXXXXXXXXXXXXXX...............
XXXXXXXXXXXXXXXXXXXXXXXXXXXXXXXXXXXXXXXXXXXXXXXXXXXXXXXXXXXXXXXXXXXXXXXXXXXXXXXX

test level
after one blank line, everything in map.txt will be ignored
so we can put whatever comments we want here 