X...............................................................................
X...............................................................................
X...............................................................................
X...............................................................................
X...............................................................................
X...............................................................................
X...............................................................................
X...............................................................................
X...............................................................................
X...............................................................................
X...............................................................................
X...............................................................................
X...............................................................................
X...............................................................................
X...............................................................................
X...............................................................................
X...............................................................................
X...............................................................................
X...............................................................................
X...............................................................................
X...............................................................................
X...............................................................................
X...............................................................................
X............................................XXXXXXXXXXXXXXXXXXXXX..............
X...............................................................................
X...............................................................................
X...............................................................................
X...............................................................................
X........e......................................................................
XXXXXXXXXXXXXXXXXXXXX...........................................................
X...............................................................................
X...............................................................................
X...............................................................................
X..........................................e....................................
X..................................XXXXXXXXXXXXXXXXXXXXX........................
X...............................................................................
X...............................................................................
X...............................................................................
X........s......................................................................
X...............................................................................
X...............................................................................
XXXXXXXXXXXXXXXXXXXXX...........................................................
XXXXXXXXXXXXXXXXXXXXX...........................................................
XXXXXXXXXXXXXXXXXXXXX...........................................................
XXXXXXXXXXXXXXXXXXXXX...........................................................
XXXXXXXXXXXXXXXXXXXXX...........................................................
XXXXXXXXXXXXXXXXXXXXX...........................................................
XXXXXXXXXXXXXXXXXXXXX...........................................................
XXXXXXXXXXXXXXXXXXXXXXXXXXXXXXXXXXXXXXXXXX......................................
XXXXXXXXXXXXXXXXXXXXXXXXXXXXXXXXXXXXXXXXXX......................................
XXXXXXXXXXXXXXXXXXXXXXXXXXXXXXXXXXXXXXXXXX......................................
XXXXXXXXXXXXXXXXXXXXXXXXXXXXXXXXXXXXXXXXXX......................................
XXXXXXXXXXXXXXXXXXXXXXXXXXXXXXXXXXXXXXXXXX...........e..........................
XXXXXXXXXXXXXXXXXXXXXXXXXXXXXXXXXXXXXXXXXXXXXXXXXXXXXXXXXXXXXXXX................
XXXXXXXXXXXXXXXXXXXXXXXXXX......................................................
XXXXXXXXXXXXXXXXXXXXXXXX........................................................
XXXXXXXXXXXXXXXXXXXXXX..........................................................
X.....................................................e.........................
X...........................................XXXXXXXXXXXXXXXXXXXXX...............
XXXXXXXXXXXXXXXXXXXXXXXXXXXXXXXXXXXXXXXXXXXXXXXXXXXXXXXXXXXXXXXXXXXXXXXXXXXXXXXX

second test level