................................................................
................................................................
................................................................
................................................................
................................................................
................................................................
................................................................
................................................................
................................................................
................................................................
................................................................
................................................................
................................................................
................................................................
................................................................
................................................................
................................................................
................................................................
................................................................
................................................................
................................................................
X...............................................................
XX..............................................................
XX..............................................................
XXX.............................................................
XXX.............................................................
XXX.............................................................
XXX.............................................................
XXX.............................................................
XXX.............................................................
XXX.............................................................
XXXX............................................................
XXXX............................................................
XXXX............................................................
XXXX............................................................
XXXX............................................................
XXXX............................................................
XXXX............................................................
XXXX............................................................
XXXX............................................................
XXXX............................................................
XXXX............................................................
XXXXXX..........................................................
XXXXXXX.........................................................
XXXXXXX.........................................................
XXXXXXXXXXXXXXXXXXXXXXXXXXXXXXXXXXXXXXXXXXXXXXXXXXXXXXXXXXXXXXXX
XXXXXXXXXXXXXXXXXXXXXXXXXXXXXXXXXXXXXXXXXXXXXXXXXXXXXXXXXXXXXXXX
XXXXXXXXXXXXXXXXXXXXXXXXXXXXXXXXXXXXXXXXXXXXXXXXXXXXXXXXXXXXXXXX
